000000000000000000000000000000000000000000000000000000000000000000000000000000000000000000000000000000000000000000000000000000000000000000000000000000000000
000000000000000000000000000000000000000000000000000000000000000000000000000000000000000000000000000000000000000000000000000000000000000000000000000000000000
000000000000000000000000000000000000000000000000000000000000000000000000000000000000000000000000000000000000000000000000000000000000000000000000000000000000
000000000000000000000000000000000000000000000000000000000000000000000000000000000000000000000000000000000000000000000000000000000000000000000000000000000000
000000000000000000000000000000000000000000000000000000000000000000000000000000000000000000000000000000000011100000000000000000000000000000000000000000000000
000000000000000000000000000111100000000000000000000000000000000000000000000000001111110000000000000000000011101100000000000000000000000011111000000000000000
111110000000000000001100000111110000000000000000001111100000000000111000000000001111111000000011111000000100001110000001111000000000000111111000000000000000
111111111000011000001111111000000011111111100000001111100000001111111000001100010000000001111111111000011100000000100001111000001100001100000000111110000000
111111111000011001111111111000000011111111111111111111111111111111111111111111110000000001111111111111111100000000111111111100001100111110000000111110000000
111111111111111001111111111111111111111111111111111111111111111111111111111111111111111111111111111111111111111111111111111111111100111110011111111111111111