000000000000000000000000000000000000000000000000000000000000000000000000000000000000000000000000000000000000000000000000000000000000000000000000000000000000
000000000000000000000000000000000000000000000000000000000000000000000000000000000000000000000000000000000000000000000000000000000000000000000000000000000000
000000000000000000000000000000000000000000000000000000000000000000000000000000000000000000000000000000000000000000000000000000000000000000000000000000000000
000000000000000000001111000000000000000000000000000000000000000000000000000000000000000000000000000000000000000000000000000000000000111100000000000000000000
000000000000000000001111000000000000000000000000000000000000000000000000000000000000000000000000000000000000000000000000000000000000111100000000000000000000
000000000000000011111100000111100000000000000000000000111000000000000000000011110000000000000000000111000000000000000000000001111000001111110000000000000000
000000001110000011111100000111111000000000000000011111111000000000000001111111111111100000000000000111111110000000000000000111111000001111110000011100000000
000000010000000111000000011111111000111100000000111111111111111000000001111111111111100000000111111111111110000000001111000111111110000000111000000010000000
111100110000101111000000011111111010111111111111111111111111111000001111111111111111111100000111111111111111111111111111010111111110000000111100000011001111
111111111000111111111111111111111000111111111111111111111111111111111111111111111111111111111111111111111111111111111111000111111111111111111111000111111111