000000000000000000000000000000000000000000000000000000000000000000000000000000000000000000000000000000000000000000000000000000000000000000000000000000000000
000000000000000000000000000000000000000000000000000000000000000000000000000000000000000000000000000000000000000000000000000000000000000000000000000000000000
000000000000000000000000000000000000000000000000000000000000000000000000000000000000000000000000000000000000000000000000000000000000000000000000000001110000
000000000000000000000000000000000000000000000000000000000000000000000000000000000000000000000000000000000000000000000000000000000000000000000000011111100011
000000000000000000000000000000000011100000000000000000000000000000000000000000011110000000000000000000000001110000000000000000000000000000000000011110000011
111100000000000000000000000000000111110000000000000000000000000000000000000000111111000000000000000000001101111000000000000000000000000000000111100000001111
111100000000000000001111100000001100000010000011100000000000000000000000000000000001100111111000000000001100000001111100000000111110000000000111100000001111
000000011111000000001111100000111100000011111111110000000000111100000000011110000011111111111000000011110000000001111111111100111110000011111111100000111111
000000111111111111111111111111111100000111111111111000000111111100001111111110000011111111111111111111110000000011111111111111111111111111111111111111111111
111111111111111111111111111111111111111111111111111111111111111111111111111111111111111111111111111111111111111111111111111111111111111111111111111111111111