000000000000000000000000000000000000000000000000000000000000000000000000000000000000000000000000000000000000000000000000000000000000000000000000000000000000
000000000000000000000000000000000000000000000000000000000000000000000000000000000000000000000000000000000000000000000000000000000000000000000000000000000000
000000000000000000000000000000000000000000000000000000000000000000000000000000000000000000000000000000000000000000000000000000000000000000000000000000000000
000000000000000000000000000000000000000000000000000000000000000000000000000000000000000000000000000000000000000000000000000000000000000000000000000000000000
111110000000000000000000000000000000000000000000000111100000000000000000000000000000000000000000000000000000000000000000000000000000000000000000000000000000
111111000000000000000000000000000000000000000000000111100000000000000000000000000000000000000000000000000000000000000000000000011000000000000000000000000000
000000000000000000001111110000000000000000000011111111111111000000000000000000000000000000111111000000000001111100000000000011111111000000000000000000000011
000000011111100000001111110000000000000111111111111111111111111110000000000000011111100000111111000000000001111100000000011111111111111000000001111110000011
000000011111111111111111111000000011111111111111111111111111111111111100000000011111111111111111100000111111111100000111111111111111111111000001111111111111
111111111111111111111111111111111111111111111111111111111111111111111111111111111111111111111111111111111111111111111111111111111111111111111111111111111111